#########
#S#  #  #
# # ## ##
#      ##
####### #
#       #
# ##### #
#     # #
##### # #
#E      #
#########
