#######
#S #   #
# ### #
#     #
# ### #
#   # #
#######
#     #
# ### #
#E    #
#######
