#######
#S#   #
# ### #
# # # #
# # # #
# ### #
#     #
#####E#
#######
