#######
#S#   #
# # ###
# #   #
# ### #
#     #
# ### #
#     #
#   ###
#E
#######
