#######
#S   ##
# ### #
#     #
# ### #
#   # #
### # #
#     #
# ### #
#E    #
#######
