#######
#S#   #
# # # #
# # # #
#     #
# ### #
# #   #
# ###E#
#######
