#######
#S    #
# ### #
#   # #
# # # #
#   # #
### # #
#     #
#  # ##
#E   #
#######
