#######
#S#####
#   ###
##### #
#     #
# ### #
#     #
#####E#
#######
