#######
#S    #
# ##### 
# #   #
# # # #
#   # #
##### #
#     #
#  ####
#E
#######
